NO                      ./sprites/north.xpm



F 255,255,255

EA ./sprites/east.xpm
SO ./sprites/south.xpm
WE ./sprites/west.xpm

C 225,30,0







        1111111111111111111111111
        1000000000110000000000001
        1011000001110000001110001
        1001000000000000001 10001
111111111011000001110000001110001
100000000011000001110000000000001
100000000011000001110111111111111
111111111111111111111111111111111111
 
111111111111111111111111111111111111
11110111111111011100000010001
11110111111111011101010010001   1
11001000110101011100000010001  101
10000000000000001100000010001   1
1000E000000000001101010010001
1100000111010101111101111000111
11110111 1110101 101111010001
11111111 1111111 111111111111