NO ./sprites/north.xpm
EA ./sprites/east.xpm
SO ./sprites/south.xpm
WE ./sprites/west.xpm

C 225,30,0				
F 1,1,1   

111111111111111111111111111111111111111111111111111111111111111111111111111111111111111111111111111111111111111111111111
101000100000000101000100000001101000100000000101000100000001101000100000000101000100000001101000100000000101000100000001
100010001000000101000100000001101010100000000101000100000001100010001000000101000100000001101010100000000101000100000001
100100110000000101000100000001111101000000000000000000000001100100110000000101000100000001111101000000000000000000000001
100001000000000000000000000001101101000000000000000000000001100001000000000000000000000001101101000000000000000000000001
100100000000000000000000000001100100000000000000000000000001100100000000000000000000000001100100000000000000000000000001
100100000000000000000000000001101010100000000101000100000001100100000000000000000000000001101010100000000101000100000001
101010100000000101000100000001101010100000000101000100000001101010100000000101000100000001101010100000000101000100000001
101010100000000101000100000001101010100000000101000100000001101010100000000101000100000001101010100000000101000100000001
101010100000000101000100000001100100000000000000000000000001101010100000000101000100000001100100000000000000000000000001
100100000000000000000000000001100100000000000000000000000001100100000000000000000000000001100100000000000000000000000001
111111111111111111111111111111111111111111111111111111111111111111111111111111111111111111111111111111111111111111111111
111111111111111111111111111111111111111111111111111111111111111111111111111111111111111111111111111111111111111111111111
101000100000000101000100000001101000100000000101000100000001101000100000000101000100000001101000100000000101000100000001
100010001000000101000100000001101010100000000101000100000001100010001000000101000100000001101010100000000101000100000001
100100110000000101000100000001111101000000000000000000000001100100110000000101000100000001111101000000000000000000000001
100001000000000000000000000001101101000000000000000000000001100001000000000000000000000001101101000000000000000000000001
100100000000000000000000000001100100000000000000000000000001100100000000000000000000000001100100000000000000000000000001
100100000000000000000000000001101010100000000101000100000001100100000000000000000000000001101010100000000101000100000001
101010100000000101000100000001101010100000000101000100000001101010100000000101000100000001101010100000000101000100000001
101010100000000101000100000001101010100000000101000100000001101010100000000101000100000001101010100000000101000100000001
101010100000000101000100000001100100000000000000000000000001101010100000000101000100000001100100000000000000000000000001
100100000000000000000000000001100100000000000000000000000001100100000000000000000000000001100100000000000000000000000001
111111111111111111111111111111111111111111111111111111111111111111111111111111111111111111111111111111111111111111111111
111111111111111111111111111111111111111111111111111111111111111111111111111111111111111111111111111111111111111111111111
101000100000000101000100000001101000100000000101000100000001101000100000000101000100000001101000100000000101000100000001
100010001000000101000100000001101010100000000101000100000001100010001000000101000100000001101010100000000101000100000001
100100110000000101000100000001111101000000000000000000000001100100110000000101000100000001111101000000000000000000000001
100001000000000000000000000001101101000000000000000000000001100001000000000000000000000001101101000000000000000000000001
100100000000000000000000000001100100000000000000000000000001100100000000000000000000000001100100000000000000000000000001
100100000000000000000000000001101010100000000101000100000001100100000000000000000000000001101010100000000101000100000001
101010100000000101000100000001101010100000000101000100000001101010100000000101000100000001101010100000000101000100000001
101010100000000101000100000001101010100000000101000100000001101010100000000101000100000001101010100000000101000100000001
101010100000000101000100000001100100000000000000000000000001101010100000000101000100000001100100000000000000000000000001
100100000000000000000000000001100100000000000000000000000001100100000000000000000000000001100100000000000000000000000001
111111111111111111111111111111111111111111111111111111111111111111111111111111111111111111111111111111111111111111111111
111111111111111111111111111111111111111111111111111111111111111111111111111111111111111111111111111111111111111111111111
101000100000000101000100000001101000100000000101000100000001101000100000000101000100000001101000100000000101000100000001
100010001000000101000100000001101010100000000101000100000001100010001000000101000100000001101010100000000101000100000001
100100110000000101000100000001111101000000000000000000000001100100110000000101000100000001111101000000000000000000000001
100001000000000000000000000001101101000000000000000000000001100001000000000000000000000001101101000000000000000000000001
100100000000000000000000000001100100000000000000000000000001100100000000000000000000000001100100000000000000000000000001
100100000000000000000000000001101010100000000101000100000001100100000000000000000000000001101010100000000101000100000001
101010100000000101000100000001101010100000000101000100000001101010100000000101000100000001101010100000000101000100000001
101010100000000101000100000001101010100000000101000100000001101010100000000101000100000001101010100000000101000100000001
101010100000000101000100000001100100000000000000000000000001101010100000000101000100000001100100000000000000000000000001
100100000000000000000000000001100100000000000000000000000001100100000000000000000000000001100100000000000000000000000001
111111111111111111111111111111111111111111111111111111111111111111111111111111111111111111111111111111111111111111111111
111111111111111111111111111111111111111111111111111111111111111111111111111111111111111111111111111111111111111111111111
101000100000000101000100000001101000100000000101000100000001101000100000000101000100000001101000100000000101000100000001
100010001000000101000100000001101010100000000101000100000001100010001000000101000100000001101010100000000101000100000001
100100110000000101000100000001111101000000000000000000000001100100110000000101000100000001111101000000000000000000000001
100001000000000000000000000001101101000000000000000000000001100001000000000000000000000001101101000000000000000000000001
100100000000000000000000000001100100000000000000000000000001100100000000000000000000000001100100000000000000000000000001
100100000000000000000000000001101010100000000101000100000001100100000000000000000000000001101010100000000101000100000001
101010100000000101000100000001101010100000000101000100000001101010100000000101000100000001101010100000000101000100000001
101010100000000101000100000001101010100000000101000100000001101010100000000101000100000001101010100000000101000100000001
101010100000000101000100000001100100000000000000000000000001101010100000000101000100000001100100000000000000000000000001
100100000000000000000000000001100100000000000000000000000001100100000000000000000000000001100100000000000000000000000001
111111111111111111111111111111111111111111111111111111111111111111111111111111111111111111111111111111111111111111111111
111111111111111111111111111111111111111111111111111111111111111111111111111111111111111111111111111111111111111111111111
101000100000000101000100000001101000100000000101000100000001101000100000000101000100000001101000100000000101000100000001
100010001000000101000100000001101010100000000101000100000001100010001000000101000100000001101010100000000101000100000001
100100110000000101000100000001111101000000000000000000000001100100110000000101000100000001111101000000000000000000000001
100001000000000000000000000001101101000000000000000000000001100001000000000000000000000001101101000000000N00000000000001
100100000000000000000000000001100100000000000000000000000001100100000000000000000000000001100100000000000000000000000001
100100000000000000000000000001101010100000000101000100000001100100000000000000000000000001101010100000000101000100000001
101010100000000101000100000001101010100000000101000100000001101010100000000101000100000001101010100000000101000100000001
101010100000000101000100000001101010100000000101000100000001101010100000000101000100000001101010100000000101000100000001
101010100000000101000100000001100100000000000000000000000001101010100000000101000100000001100100000000000000000000000001
100100000000000000000000000001100100000000000000000000000001100100000000000000000000000001100100000000000000000000000001
111111111111111111111111111111111111111111111111111111111111111111111111111111111111111111111111111111111111111111111111