NO	./sprites/north.xpm
EA	./sprites/east.xpm
SO	./sprites/south.xpm
WE	./sprites/west.xpm
D	./sprites/door.xpm

C 225,255,255			
F 1,1,1     


1111111
1001001
100D001
110N011
1000001
1001001
1111111