NO	./sprites/north.xpm     
EA	./sprites/east.xpm
SO	./sprites/south.xpm
WE	./sprites/west.xpm
D	./sprites/door.xpm

C 225,255,255			
F 1,1,1

11111
10101
10WD1
10001
11111